TURNOUT( 1, 1, 0 [, "description"]|HIDDEN )
T 1 DCC 1 0
T 2 DCC 1 1
T 3 DCC 1 2
T 4 DCC 1 3
T 5 DCC 2 0
T 6 DCC 2 1
T 7 DCC 2 2
T 8 DCC 2 3
T 9 DCC 3 0
T 10 DCC 3 1
T 11 DCC 3 2
T 12 DCC 3 3
T 13 DCC 4 0
T 14 DCC 4 1
T 15 DCC 4 2
T 16 DCC 4 3
T 17 DCC 5 0
T 18 DCC 5 1
T 19 DCC 5 2
T 20 DCC 5 3
T 21 DCC 6 0
T 22 DCC 6 1
T 23 DCC 6 2
T 24 DCC 6 3
T 25 DCC 7 0
T 26 DCC 7 1
T 27 DCC 7 2
T 28 DCC 7 3
T 29 DCC 8 0
T 30 DCC 8 1
T 31 DCC 8 2
T 32 DCC 8 3
